10 cols
13 rows

1 1 1 1 1 1 1 1 1 1
1 0 0 0 0 0 0 0 0 92
1 0 0 3 3 0 0 0 0 2
1 0 0 0 0 0 0 0 0 1
1 0 0 0 0 0 0 0 0 1
1 0 0 0 0 0 0 0 0 1
1 0 0 0 0 0 0 0 0 1
1 0 0 0 0 0 0 0 0 1
1 0 0 0 0 1 1 1 1 1
1 4 4 0 0 1 -3 -4 -5 1
1 4 0 0 0 1 -2 -5 -3 91
1 0 0 0 0 -1 -1 -2 -4 1
1 1 1 1 1 1 1 1 1 1 1

maps/simple 1 3
maps/room 18 10
