10 cols
10 rows

1 1 1 1 1 1 1 1 1 1
1 0 0 0 0 0 0 0 0 1
1 0 0 0 0 0 0 0 0 1
1 0 0 0 0 0 0 0 0 1
1 0 0 0 0 0 0 0 0 1
1 0 0 0 0 1 1 1 1 1
1 0 0 0 0 1 -1 -1 -1 1
1 0 0 0 0 1 -1 -1 -1 1
1 0 0 0 0 -1 -1 -1 -1 1
1 1 1 1 1 1 1 1 1 1
