10 cols
10 rows

1 1 1 1 1 1 1 1 1 1
1 0 0 0 0 0 0 0 0 1
1 0 0 3 3 0 0 0 0 1
1 0 0 0 0 0 0 0 2 1
1 0 0 0 0 0 0 0 0 1
1 0 0 0 0 1 1 1 1 1
1 4 4 0 0 1 -1 -1 -1 1
1 4 0 0 0 1 -1 2 -1 1
1 0 0 0 0 -1 -1 -1 -1 1
1 1 1 1 1 1 1 1 1 1

maps/simple
maps/room
